#   #   #   #   #   #   #   #   #   #   #   #   #
#   .   .   .   .   .   #   @   .   .   .   #   #
#   .   0   .   .   #   .   .   .   .   #   .   #
#   .   .   @   #   .   .   .   @   #   .   .   #
#   .   .   #   .   .   .   .   #   @   .   .   #
#   .   #   .   .   .   .   #   .   .   .   @   #
#   #   .   .   .   .   #   .   .   .   .   #   #
#   @   .   .   .   #   .   .   .   .   #   .   #
#   .   .   @   #   .   .   .   .   #   .   .   #
#   .   .   #   @   .   .   .   #   @   .   .   #
#   .   #   .   .   .   .   #   .   .   1   .   #
#   #   .   .   .   @   #   .   .   .   .   .   #
#   #   #   #   #   #   #   #   #   #   #   #   #